{
  "cols": 15,
  "rows": 15,
  "playerStart": [7, 14],
  "data": [
    [2, 2, 2, 2, 2, 2, 2, 0, 2, 2, 2, 2, 2, 2, 2],
    [2, 0, 0, 0, 0, 0, 0, 0, 0, 0, 0, 0, 0, 0, 2],
    [2, 0, 0, 0, 0, 0, 0, 0, 0, 0, 0, 0, 0, 0, 2],
    [2, 0, 0, 3, 3, 0, 0, 0, 0, 0, 0, 0, 0, 0, 2],
    [2, 0, 0, 4, 4, 0, 0, 0, 0, 0, 0, 0, 0, 0, 2],
    [2, 0, 0, 0, 0, 0, 0, 0, 0, 0, 0, 0, 0, 0, 2],
    [2, 0, 0, 0, 0, 0, 0, 0, 0, 0, 0, 0, 0, 0, 2],
    [2, 0, 0, 0, 0, 0, 0, 0, 0, 0, 0, 0, 0, 0, 2],
    [2, 0, 0, 0, 0, 0, 0, 0, 0, 0, 0, 0, 0, 0, 2],
    [2, 0, 0, 0, 0, 0, 0, 0, 0, 0, 0, 0, 0, 0, 2],
    [2, 0, 0, 0, 0, 0, 0, 0, 0, 0, 5, 0, 0, 0, 2],
    [2, 0, 0, 0, 0, 0, 0, 0, 0, 0, 5, 0, 0, 0, 2],
    [2, 0, 0, 3, 3, 0, 0, 0, 0, 0, 0, 0, 0, 0, 2],
    [2, 0, 0, 4, 4, 0, 0, 0, 0, 0, 0, 0, 0, 0, 2],
    [2, 2, 2, 2, 2, 2, 2, 0, 2, 2, 2, 2, 2, 2, 2]
  ]
}
