{
  "cols": 10,
  "rows": 10,
  "playerStart": [0, 5],
  "data": [
    [2, 2, 2, 2, 2, 2, 2, 2, 2, 2],
    [2, 0, 0, 0, 6, 6, 6, 0, 0, 2],
    [2, 0, 0, 0, 0, 0, 0, 0, 0, 2],
    [2, 0, 0, 0, 6, 6, 6, 0, 0, 2],
    [2, 0, 0, 0, 0, 0, 0, 0, 0, 2],
    [0, 0, 0, 0, 0, 6, 6, 0, 0, 2],
    [2, 0, 0, 0, 0, 0, 0, 0, 0, 2],
    [2, 0, 0, 0, 6, 6, 6, 0, 0, 2],
    [2, 0, 0, 0, 0, 0, 0, 0, 0, 2],
    [2, 2, 2, 2, 2, 2, 2, 2, 2, 2]
  ]
}
